####################
#   #  A        # ##
# # # ##### ### # ##
# #     #   # # # ##
######### ### # # ##
#         #   #   ##
# ######### # ### ##
# #         # #   ##
# ####### ##### ####
#       #         ##
# ##### # ##########
#   #   # #       ##
##### # ### ##### ##
#     # #   #   # ##
# ##### # ### # # ##
# #     # #   # # ##
# ####### ### # # ##
#             # # ##
###############B####
####################
